R 1920 1080
NO /home/abdurahim/Desktop/42_c_projects/Cub3D/textures/north_64x64.xpm
SO /home/abdurahim/Desktop/42_c_projects/Cub3D/textures/south_64x64.xpm
WE /home/abdurahim/Desktop/42_c_projects/Cub3D/textures/west_64x64.xpm
EA /home/abdurahim/Desktop/42_c_projects/Cub3D/textures/east_64x64.xpm
S /home/abdurahim/Desktop/42_c_projects/Cub3D/textures/sprite_64x64.xpm
F 225,210,180
C 180,210,225

1111111111111111111111111111111111111111111111111111111111111111111111111111111111111111
1000000000000000000000000000000000000000000000000000000000000000000000000000000000000001
1011111111111111111111111111111111111111111111111111111111111111111111111111111111111101
1010000000000000000000000000000000000000000000000000000000000000000000000000000000000101
1010111111111111111111111111111111111111111111111111111111111111111111111111111111100101
1010100000000000000000000000000000000000000000000000000000000000000000000000000010100101
1010101111111111111111111111111111111111111111111111111111111111111111111111111010100101
1010101000000000000000000000000000000000000000000000000000000000000000000000010010100101
1010101001111111111111111111111111111111111111111111111111111111111111111111010110100101
1010101000000000000000000000000000000000000000000000000000000000000000000001010100100101
1010101000011111111111111111111111111111111111111111111111111111111111111101010101100101
1010101000000000000000000000000000000000000000000000000000000000000000000101010100100101
1010101000001111111111111111111111111111111111111111111111111111111111010101010110100101
1010101000001000000000000000000000000000000000000000000000000000000001010101010100100101
1010101000001011111111111111111111111111111111111111111111111111111101010101010101100101
1010101000001010000000000000000000000000000000000000000000000000010101010101010100100101
1010101000001010111111111111111111111111111111111111111111111111010101010101010110100101
1010101000001010100000000000000000000000000000000000000000000101010101010101010100100101
1010101000001010101111111111111111111111111111111111111111101010101010101010101100100101
1010101000001010101000000000000000000000000000000000000010101010101010101010100100100101
1010101000001010101011111111111111111111111111111111010101010101010101010111100100100101
1010101000001010101010000000000000000000000000000101010101010101010101010000100100100101
1010101000001010101010111111111111111111111111101010101010101010101010111110100100100101
101010100N001010101010100000000000000000000101010101010101010101010100000100100100100101
1010101000001010101010101111111111111111101010101010101010101010101111100100100100100101
1010101010101010101010101000000000000010101010101010101010101010100000100100100100100101
1010101010101010101010101011111111111010101010101010101010101010111110100100100100100101
1010101010101010101010101010000000010101010101010101010101010000000100100100100100100101
1010101010101010101010101010111111010101010101010101010101011111111100100100100100100101
1010101010101010101010101010100001010101010101010101010101000000000100100100100100100101
1010101010101010101010101010101111010101010101010101010101111111110100100100100100100101
1010101010101010101010101010101000010101010101010101010100000000010100100100100100100101
1010101010101010101010101010101111110101010101010101010111111111010100100100100100100101
1010101010101010101010101010100000000101010101010101000000000001010100100100100100100101
1010101010101010101010101010111111111101010101010101111111111101010100100100100100100101
1010101010101010101010101010000000000001010101010100000000000101010100100100100100100101
1010101010101010101010101011111111111111010101010111111111110101010100100100100100100101
1010101010101010101010101000000000000000010101010000000000010101010100100100100100100101
1010101010101010101010101111111111111111111111111111111111111111111100100100100100100101
1000000000000000000000000000000000000000000000000000000000000000000000000000000000000001
1111111111111111111111111111111111111111111111111111111111111111111111111111111111111111
