R 1920 1080
NO /home/abdurahim/Desktop/42_c_projects/Cub3D/textures/north_64x64.xpm
SO /home/abdurahim/Desktop/42_c_projects/Cub3D/textures/south_64x64.xpm
WE /home/abdurahim/Desktop/42_c_projects/Cub3D/textures/west_64x64.xpm
EA /home/abdurahim/Desktop/42_c_projects/Cub3D/textures/east_64x64.xpm
S /home/abdurahim/Desktop/42_c_projects/Cub3D/textures/sprite_64x64.xpm
F 120,120,120
C 225,225,225

11111111111111111111111111111111111111111111111111
10000000000000000000000000000000000000000000000001
10111111111111111111111111111111111111111111111001
10100000000000000000000000000000000000000000001001
10101111111111111111111111111111111111111111101001
10101000000000000000000000000000000000000000101001
10101011111111111111111111111111111111111110101001
10101010000000000000000000000000000000000100101001
10101010111111111111111111111111111111110101101001
10101010100000000000000000000000000000010101001001
10101010101111111111111111111111111111010101011001
10101010101000000000000000000000000101010100001001
10101010101011111111111111111111110101010101111001
10101010101010000000000000000000010101010101001001
10101010101010111111111111111111010101010101011001
10101010101010100000000000000101010101010101001001
10101010101010101111111111110101010101010101111001
10101010101010101000000001010101010101010101001001
10101010101010101011111101010101010101010101011001
10101010101010101010000101010101010101010101001001
10101010101010101010110101010101010101010101111001
10101010101010101010100101010101010101010100001001
10101010101010101010101101010101010101010111101001
10101010101010101010100001010101010101010000101001
10101010101010101010111111010101010101011110101001
10101010101010101010000001010101010101000010101001
10101010101010101011111101010101010101111010101001
10101010101010101000000101010101010001000010101001
10101010101010101111110101010101011101011110101001
10101010101010100000010101010100000101000010101001
10101010101010111111010101010111110101111010101001
10101010101010000001010101010000000101000010101001
1010101N101011111101010101011111110101111010101001
10101010101000000101010101000000000101000010101001
10101010101111110101010101111111110101111010101001
10101010100000010101010100000000000101000010101001
10101010111111010101010111111111110101111010101001
10101010000001010101010000000000000101000010101001
10101011111101010101011111111111110101111010101001
10101000000101010101000000000000000101000010101001
10101111110101010101111111111111110101111010101001
10100000010101010100000000000000000101000010101001
10111111010101010111111111111111110101111010101001
10000001010101010000000000000000000101000010101001
11111101010101011111111111111111110101111010101001
10000101010101000000000000000000000101000010101001
10110101010101111111111111111111110101111010101001
10010101010100000000000000000000000101000010101001
11010101010111111111111111111111110101111010101001
10000101010000000000000000000000000101000000101001
11111111111111111111111111111111111111111111111111