R 1920 1080
NO /home/abdurahim/Desktop/42_c_projects/Cub3D/textures/north_64x64.xpm
SO /home/abdurahim/Desktop/42_c_projects/Cub3D/textures/south_64x64.xpm
WE /home/abdurahim/Desktop/42_c_projects/Cub3D/textures/west_64x64.xpm
EA /home/abdurahim/Desktop/42_c_projects/Cub3D/textures/east_64x64.xpm
S /home/abdurahim/Desktop/42_c_projects/Cub3D/textures/sprite_64x64.xpm
F 20,20,20
C 50,50,0

1111111111111111111111111111111111111111111111111111111111111111111111111111111111111111111111111111
1000000000000000000000000000001000000000000000000000000000000010000000000000000000000000000000100001
1000000000000000000000000000001000000000000000000000000000000010000000000000000000000000000000100001
1000000000000000000000000000001000000000000000000000000000000010000000000000000000000000000000100001
1000000111110000000000000000001000000000000000000000000000000010000000000000000000000000000000100001
1000000100010000000000000000001000000000000000000000000000000010000000000000000000000000000000100001
1000000100010000000000000000001000000000000000000000000000000010000000000000000000000000000000100001
1000000111110000000000000000001111111111111111111111111111111110000000000000000000000000000000100001
1000000000000000000000000000000000000000000000000000000000000000000000000000000000000000000000100001
1000000000000000000000000000000000000000000000000000000000000000000000000000000000000000000000100001
1000000000000000000000000000000000000000000000000000000000000000000000000000000000000000000000100001
1000000000000000000000000000001111111111111111111111111111111110000000000000000000000000000000100001
1000000000000000000000000000001000000000000000000000000000000010000000000000000000000000000000100001
1000000000000000000000000000001000000000000000000000000000000010000000000000000000000000000000100001
1000000000000000000000000000001000000000000000000000000000000010000000000000000000000000000000100001
1000000000000000000000000000001000000000000000000000000000000010000000111111111111111111111111100001
1000000000000000000000000000001000000000000000000000000000000010000000100000000000000000000000000001
1000000000000000000000000000001000000000000000000000000000000010000000100000000000000000000000000001
1000000000000000000000000000001111111100001111111111111111111110000000100000000000000000000000000001
1000000000000000000000000000000000000100001000000000000000000000000000100000000000000000000000000001
1000000000000000000000000000000000000100001000000000000000000000000000100000000000000000000000000001
1000000000000000000000000000000000000100001000000000000000000000000000100000000000000000000000000001
1000000000000000000000000000000000000100001000000000000000000000000000100000000000000000000000000001
1000000000000000000000000000000000000100001000000000000000000000000000111111111111111111111111100001
1000000000000000000000000000000000000100001000000000000000000000000000000000000000000000000000100001
1000000000000000000000000000000000000100001000000000000000000000000000000000000000000000000000100001
1000000000000000000000000000000000000100001000000000000000000000000000000000000000000000000000100001
1000000000000000000000000000000000000100001000000000000000000000000000000000000000000000000000100001
1000000000000000000000000000000000000100001000000000000000000000000000000000000000000000000000100001
1000000000000000000000000000000111111100001111111111111111111111111111111111111110000111111111100001
1000000000000000000000000000000100000000000000000000000000000000000000000000000000000000000000000001
1000000000000000000000000000000100000000000000000000000000000000000000000000000000000000000000000001
1000000000000000000000000000000100000000000000000000000000000000000000000000000000000000000000000001
1111111001111111000000000000000100000000000000000000000000000000000000000000000000000000000000000001
1000000000000001000000000000000100000000000000000000000000000000000000000000000000000000000000000001
1000000000000001000000000000000100000000000000000000000000000000000000000000000000000000000000000001
1000000000000001000000000000000100000000000000000000000000000000000000000000000000000000000000000001
1000000000000001000000000000000100000000000000000000000000000000000000000000000000000000000000000001
1000000N00000001111111111111111100000000000000000000000000000000000000000000000000000000000000000001
1000000000000000000000000000000000000000000000000000000000000000000000000000000000000000000000000001
1000000000000000000000000000000000000000000000000000000000000000000000000000000000000000000000000001
1000000000000000000000000000000000000000000000000000000000000000000000000000000000000000000000000001
1000000000000000000000000000000000000000000000000000000000000000000000000000000000000000000000000001
1000000000000000000000000000000000000000000000000000000000000000000000000000000000000000000000000001
1000000000000000000000000000000000000000000000000000000000000000000000000000000000000000000000000001
1000000000000000000000000000000000000000000000000000000000000000000000000000000000000000000000000001
1000000000000000000000000000000000000000000000000000000000000000000000000000000000000000000000000001
1000000000000000000000000000000000000000000000000000000000000000000000000000000000000000000000000001
1000000000000000000000000000000000000000000000000000000000000000000000000000000000000000000000000001
1000000000000000000000000000000000000000111111111111111111111111111100000000000000000000000000000001
1000000000000000000000000000000000000000100000000000000000000000000100000000000000000000000000000001
1000000000000000000000000000000000000000100000000000000000000000000100000000000000000000000000000001
1000000000000000000000000000000000000000100000000000000000000000000100000000000000000000000000000001
1000000000000000000000000000000000000000100000000000000000000000000100000000000000000000000000000001
1000000000000000000000000000000000000000100000000000000000000000000100000000000000000000000000000001
1000000000000000000000000000000000000000100000000000000000000000000100000000000000000000000000000001
1000000000000000000000000000000000000000100000000000000000000000000100000000000000000000000000000001
1000000000000000000000000000000000000000100000000000000000000000000100000000000000000000000000000001
1000000000000000000000000000000000000000100000000000000000000000000100000000000000000000000000000001
1000000000000000000000000000000000000000111111111111111111111111111100000000000000000000000000000001
1000000000000000000000000000000000000000000000000000000000000000000000000000000000000000000000000001
1000000000000000000000000000000000000000000000000000000000000000000000000000000000000000000000000001
1000000000000000000000000000000000000000000000000000000000000000000000000000000000000000000000000001
1000000000000000000000000000000000000000000000000000000000000000000000000000000000000000000000000001
1000000000000000000000000000000000000000000000000000000000000000000000000000000000000000000000000001
1000000000000000000000000000000000000000000000000000000000000000000000000000000000000000000000000001
1000000000000000000000000000000000000000000000000000000000000000000000000000000000000000000000000001
1000000000000000000000000000000000000000000000000000000000000000000000000000000000000000000000000001
1000000000000000000000000000000000000000000000000000000000000000000000000000000000000000000000000001
1000000000000000000000000000000000000000000000000000000000000000000000000000000000000000000000000001
1000000000000000000000000000000000000000000000000000000000000000000000000000000000000000000000000001
1000000000000000000000000000000000000000000000000000000000000000000000000000000000000000000000000001
1000000000000000000000000000000000000000000000000000000000000000000000000000000000000000000000000001
1000000000000000000000000000000000000000000000000000000000000000000000000000000000000000000000000001
1000000000000000000000000000000000000000000000000000000000000000000000000000000000000000000000000001
1000000000000000000000000000000000000000000000000000000000000000000000000000000000000000000000000001
1000000000000000000000000000000000000000000000000000000000000000000000000000000000000000000000000001
1000000000000000000000000000000000000000000000000000000000000000000000000000000000000000000000000001
1000000000000000000000000000000000000000000000000000000000000000000000000000000000000000000000000001
1000000000000000000000000000000000000000000000000000000000000000000000000000000000000000000000000001
1000000000000000000000000000000000000000000000000000000000000000000000000000000000000000000000000001
1000000000000000000000000000000000000000000000000000000000000000000000000000000000000000000000000001
1000000000000000000000000000000000000000000000000000000000000000000000000000000000000000000000000001
1000000000000000000000000000000000000000000000000000000000000000000000000000000000000000000000000001
1000000000000000000000000000000000000000000000000000000000000000000000000000000000000000000000000001
1000000000000000000000000000000000000000000000000000000000000000000000000000000000000000000000000001
1000000000000000000000000000000000000000000000000000000000000000000000000000000000000000000000000001
1000000000000000000000000000000000000000000000000000000000000000000000000000000000000000000000000001
1000000000000000000000000000000000000000000000000000000000000000000000000000000000000000000000000001
1000000000000000000000000000000000000000000000000000000000000000000000000000000000000000000000000001
1000000000000000000000000000000000000000000000000000000000000000000000000000000000000000000000000001
1111111111111111111111111111111111111111111111111111111111111111111111111111111111111111111111111111