R 1920 1080
NO ./textures/north.xpm
SO ./textures/south.xpm
WE ./textures/west.xpm
EA ./textures/east.xpm
S ./textures/sprite.xpm
F 220,100,0
C 225,30,0
1111111111111
1N00000000001
1011110111101
1010010100101
1010110100101
1010000100101
1111111111111
