R 1024 768

NO   ./textures/north.xpm

SO   ./textures/south.xpm

WE   ./textures/west.xpm

EA   ./textures/east.xpm

S    ./textures/sprite.xpm

F 0,255,127

C 255,255,255

11111
1N001
10001
10201
11111
