R 800 600
NO ./textures/north.xpm
SO ./textures/south.xpm
WE ./textures/west.xpm
EA ./textures/east.xpm
S ./textures/sprite.xpm
F 100,100,100
C 200,200,200

11111
1N0S1
10001
11111
